NO ./textures/north.xpm




SO ./textures/south.xpm





WE ./textures/west.xpm





EA ./textures/east.xpm











F 0,0,0
C 255,255,255



















 111111111111
 100000111111







1110N00011111
1000000011111
1111111111111
