NO ./textures/north.xpm
SO ./textures/south.xp
WE ./textures/west.xpm
EA ./textures/east.xpm

F 0,0,0
C 255,255,255

1111111
11S11111
11000011
11000011
111111111
1	 11
1111111

