NO ./textures/north.xpm
SO ./textures/south.xpm
WE ./textures/west.xpm
EA ./textures/east.xpm

F 0,0
C 255,255,255

  1111111
  1000001
1110N0001
100000001
111111111
