NO ./textures/north.xpm
SO ./textures/south.xpm
WE ./textures/west.xpm
EA ./textures/east.xpm

F 0,0,0
C 255,255,255

  1111111
  1000001
111000001
100000001
111111111
